R 1500 800
NO ./texture/pics/bluestone.png
SO ./texture/pics/colorstone.png
WE ./texture/pics/greystone.png
EA ./texture/pics/mossy.png

S ./texture/pics/barrel.png
F 220,100,0
C 225,30,0

111111111
122000001
100000201
100020001
102000S21
100000201
111111111
