R 1500 800
NO ./texture/pics/bluestone.png
SO ./texture/pics/colorstone.png
WE ./texture/pics/greystone.png
EA ./texture/pics/mossy.png

S ./texture/pics/barrel.png
F 220,100,0
C 225,30,0

1111 1111
1W01 1001
1111 1111
