R 1500 800
NO ./texture/pics/bluestone.png
SO ./texture/pics/colorstone.png
WE ./texture/pics/greystone.png
EA ./texture/pics/mossy.png

S ./texture/pics/barrel.png
F 225,0,0
C 0,255,0

111111111
122000001
100000201
1000200N1
102000021
100000201
111111111
