R 1500 800
NO ./texture/pics/bluestone.png
SO ./texture/pics/colorstone.png
WE ./texture/pics/greystone.png
EA ./texture/pics/mossy.png

S ./texture/pics/barrel.png
F 220,100,0
C 225,30,0

        1111111111111111111111111
        1000000000110000000000001
        1011000001110000001000001
        1001000000000000000000001
111111111011000001110000000000001
100000000011000001110111111111111
11110111111111011100000000001
1111011111111101110101001E001
11000000110101011100000010001
10001000000000001101000010201
10000000000000001101010010001
1100000111010101111101111020111
11110111 1110101 101111010001
11111111 1111111 111111111111
