R 2000 2000
NO ./texture/pics/bluestone.png
SO ./texture/pics/colorstone.png
WE ./texture/pics/greystone.png
EA ./texture/pics/mossy.png

S ./texture/pics/barrel.png
F 225,0,0
C 0,255,0

111111111
122000E01
100000201
100020001
102000021
100000201
111111111
